# Dungeon MinotaurPuzzle anonymous map 13x13
▓▓▓▓▓▓▓▓▓▓▓▓▓
▓▓▓▓••••••••▓
▓▓▓▓▓•••▓•▓•▓
▓•••••▓•▓•••▓
▓••▓▓•▓▓▓▓••▓
▓•••▓▓•▓••▓•▓
▓☻•••••▓▓•▓•▓
▓••••••••◄▓•▓
▓•••••▓•••▓▓▓
▓▓••☀••▓••••▓
▓▓•••••▓•▓▓•▓
▓•••▓•▓•••••▓
▓▓▓▓▓▓▓▓▓▓▓▓▓
