# Dungeon StoneAgePuzzle level-1 map 20x11
···············▓▓▓··
·········▓▓▓▓▓▓▓·▓··
·······▓▓▓····••·▓··
······▓▓·····••►·▓··
······▓···•·←••··▓··
······▓··••·←•·▓▓▓··
······▓◄•••···▓▓····
······▓•••···▓▓·····
······▓▓▓▓··▓▓······
·········▓▓▓▓·······
····················
