# Dungeon StoneAgePuzzle level-3 map 20x11
·····▓▓·············
···▓▓·•▓▓·····▓▓▓···
··▓···•·▓▓▓▓▓▓▓·◄▓··
·▓····•·•·•·•·•·•▓··
▓·····•·•·•·•·•··▓▓·
▓··→··············▓·
▓····•·•·•·•·•····▓·
·▓·↑·•·•·•·•·•····▓·
··▓►·▓▓•·•·•·→↑·↑▓··
···▓▓··▓▓▓·•·•·▓▓···
··········▓▓▓▓▓·····
