# Dungeon StoneAgePuzzle level-5 map 20x11
····················
···▓▓▓▓▓▓▓▓▓▓▓▓▓····
··▓▓·▓·▓↕·▓↕▓↕►▓····
··▓··········✥·▓····
··▓▓··········▓▓····
···▓▓········▓▓·····
··▓▓··········▓▓····
··▓·✥··········▓····
··▓◄↕▓↕▓·↕▓·▓·▓▓····
··▓▓▓▓▓▓▓▓▓▓▓▓▓·····
····················
