# Dungeon StoneAgePuzzle level-9 map 20x11
····▓▓▓▓···▓▓▓▓▓▓···
··▓▓▓··▓▓·▓▓▓▓••▓▓··
·▓······▓▓↓··•••••▓·
▓········↓···▓•▓▓••▓
•▓······→·······←▓•▓
►•→·······↓·▓··▓▓••▓
▓•··········▓↑▓▓••▓·
·▓▓·→↑▓▓▓····▓··▓◄▓·
··▓▓▓▓▓·▓▓·▓▓▓···▓··
·········▓▓▓········
····················
