# Dungeon MirrorPuzzle 3x6-2 map 13x13
·············
·············
·············
·····◎✧◎·····
·····◎◎◎·····
·····◎◎◎·····
·····◎◎◎·····
·····◎◎◎·····
·····◎◎✦·····
·············
·············
·············
·····►◦◄·····
\ 0*
\ 0*
/ 0*
\ 1*
- 1
/ 0*
| 1
/ 1
/ 0*
\ 0*
/ 0*
\ 0*
/ 0*
\* 0*
-* 0*
- 0*
