# Dungeon MirrorPuzzle glass+barrels/zsb+traps map 13x13
▒▒▒▒▒▒▒▒▒▒▒▒▒
▒░░░▬░░░░░░✧▒
▒░▓▓⬧▓▓▓▓▓▓░▒
▒░▓☻••••••▓░▒
▒░▓•░•░▬░•▓░▒
▒░▓•▬•▬•••▓░▒
▒░⬧•░▬░▬░•⬧░▒
▒░▓•••▬•▬•▓░▒
▒░▓•░▬░•░•▓░▒
▒░▓•••••••▓░▒
▒░▓▓▓▓▓▓⬧▓▓░▒
▒✦░░░░░░▬░░░▒
▒▒▒▒▒▒▒▒▒▒▒▒▒
\* 1
\ 1
/ 1
/ 1
/* 1
/* 1
/ 1
/ 1
/ 1
/* 1
