# Dungeon MirrorPuzzle gates+barrels map 13x13
▓▓▓▓▓▓▓▓▓▓▓▓▓
▓✧▓•••••••••▓
▓•▓•▓▓▓▓▓▓▓☻▓
▓★▓•▓▓▓▓▓▓▓•▓
▓•••••••••••▓
▓•▓▓▓•••▓▓▓▓▓
▓•▓▓▓•••▓••𝟘▓
▓•••••••▓•▬■▓
▓𝟘▓▓▓▓▬▓▓•▬•▓
▓☆▓•••••▬•••▓
▓••••▬••▬•▓▓▓
▓✦▓••••••••⎵▓
▓▓▓▓▓▓▓▓▓▓▓▓▓
1
0
/* 1
/* 1*
/* 1
/* 1
/* 1
/* 1
0 1
