# Dungeon MirrorPuzzle gates+locks+portals+glass+barrels map 13x13
☻•••••𝟘••••★⎵
★••✦▬•▓•••▬•★
²★•••••••••★¹
▓▓▓▓▓▓░▓▓▓▓▓▓
⎵𝟚•••••••••★⎵
𝟚••••••••••▬★
•••••••••••𝟙¹
••••••••••••★
⎵••••••••••••
•••••••••••••
••••••••••••▓
𝟚▬▓••••••••★𝟙
²𝟚••••𝟘••••▓✧
1
0
-* 1
|* 1
-* 1
/* 1
1 3
5 8
4
0
