# Dungeon MirrorPuzzle Barrel Mirror map 13x13
▓▓▓▓▓▓▓▓▓▓▓▓▓
▓▓▓▓▓▓◌■■■■✧▓
▓••••••••••☻▓
▓•▓▓▓▓𝟚▓▓▓▓▓▓
▓•▓▓▓▓▬▓▓▓▓▓▓
▓•••••¹•••••▓
▓▓▓▓▓▓⇕▓▓▓▓•▓
▓•••••²•••••▓
▓▓▓▓▓▓▬▓▓▓▓•▓
▓▓▓▓▓▓𝟙▓▓▓▓•▓
▓◄••••••••••▓
▓✦■■■■◌▓▓▓▓▓▓
▓▓▓▓▓▓▓▓▓▓▓▓▓
/ 1
- 1
- 1*
- 1
/ 1
