# Dungeon MirrorPuzzle Barrel Mirror map 13x13
▓▓▓▓▓▓▓▓▓▓▓▓▓
▓✧•••••••••☻▓
▓▓••••••••••▓
▓•••••••••••▓
▓•▓•▓▓▓▓▓▓▓■▓
▓•▓•••••••▓■▓
▓•▓•▓▓▬▓▓•▓■▓
▓•▓•••••••▓■▓
▓•▓▓▓▓▓▓▓•▓■▓
▓•••••••••••▓
▓•••••••••▬•▓
▓•••••✦•••••▓
▓▓▓▓▓▓▓▓▓▓▓▓▓
-* 1
\* 1
