# Dungeon AtomixPuzzle Ethylene map 13x13
·············
·▓▓▓·····▓▓▓·
·▓·▓·····▓·▓·
·▓0▓▓▓▓▓▓▓·▓·
·▓······▓··▓·
·▓▓··0·▓···▓·
·▓·▓····0▓0▓·
·▓···▓····▓▓·
·▓··▓····00▓·
·▓·▓▓▓▓▓▓▓·▓·
·▓·▓·····▓·▓·
·▓▓▓·····▓▓▓·
·············
H↗
C↗↘⇇
H↙
C↖↙⇉
H↖
H↘
4 3
0 0 H↘
3 0 H↙
1 1 C↖↙⇉
2 1 C↗↘⇇
0 2 H↗
3 2 H↖
