# Dungeon AtomixPuzzle Methane map 13x13
·············
▓▓▓▓▓▓▓▓▓▓▓▓▓
▓···▓··▓····▓
▓·▓··▓0▓····▓
▓··▓···▓0·▓·▓
▓······▓▓▓▓·▓
▓·······▓0▓·▓
▓·0··▓··▓···▓
▓·▓▓▓▓▓····▓▓
▓·0·▓··▓···▓·
▓▓▓▓▓··▓···▓·
·······▓▓▓▓▓·
·············
H←
C←↑→↓
H→
H↓
H↑
3 3
1 0 H↓
0 1 H→
1 1 C←↑→↓
2 1 H←
1 2 H↑
