# Dungeon AtomixPuzzle Water map 13x13
·············
·▓▓▓▓▓·······
·▓···▓·······
·▓··0▓▓▓▓▓▓··
·▓··▓·····▓··
·▓·▓······▓▓·
·▓·▓····▓▓·▓·
·▓····▓·▓0·▓·
·▓▓▓0▓··▓··▓·
··▓········▓·
··▓▓▓▓▓▓▓▓▓▓·
·············
·············
H←
O←→
H→
3 1
0 0 H→
1 0 O←→
2 0 H←
