____#####_###
____#---#_#.#
____#$--#_#.#
__###--$###.#
__#--$--$-#.#
###-#-###-#.#
#---#-###-#.#
#-$--$-----@#
#####-####--#
____#------##
____########_
Title: Modified Thinking Rabbit #1
Move-Record: 210/82
Push-Record: 210/82
